0000000000000000000000000000000000000000000000000000000000000000000000000000000
0000000000000000000000000000000000000011110000000000000000000000000000000000000
0000000000000000000000000000000000000110110000000000000000000000000000000000000
0000000000000000000000000000000000001100110000000000000000000000000000000000000
0000000000000000000000000000000000011000110000000000000000000000000000000000000
0000000000000000000000000000000000110000110000000000000000000000000000000000000
0000000000000000000000000000000000000000110000000000000000000000000000000000000
0000000000000000000000000000000000000000110000000000000000000000000000000000000
0000000000000000000000000000000000000000110000000000000000000000000000000000000
0000000000000000000000000000000000000000110000000000000000000000000000000000000
0000000000000000000000000000000000000000110000000000000000000000000000000000000
0000000000000000000000000000000000000011111100000000000000000000000000000000000
0000000000000000000000000000000000000000000000000000000000000000000000000000000
0000000000000000000000000000000000001111111110000000000000000000000000000000000
0000000000000000000000000000000001110000000011000000000000000000000000000000000
0000000000000000000000000000000011000000000001100000000000000000000000000000000
0000000000000000000000000000000110000000000001100000000000000000000000000000000
0000000000000000000000000000000000000000000011000000000000000000000000000000000
0000000000000000000000000000000000000000001110000000000000000000000000000000000
0000000000000000000000000000000000000000111000000000000000000000000000000000000
0000000000000000000000000000000000000011100000000000000000000000000000000000000
0000000000000000000000000000000000001110000000000000000000000000000000000000000
0000000000000000000000000000000001111000000000000000000000000000000000000000000
0000000000000000000000000000000111111111111111000000000000000000000000000000000
0000000000000000000000000000000000000000000000000000000000000000000000000000000
0000000000000000000000000000000000001111111110000000000000000000000000000000000
0000000000000000000000000000000001110000000011000000000000000000000000000000000
0000000000000000000000000000000000000000000001100000000000000000000000000000000
0000000000000000000000000000000000000000000001100000000000000000000000000000000
0000000000000000000000000000000000000000000011000000000000000000000000000000000
0000000000000000000000000000000000000011111110000000000000000000000000000000000
0000000000000000000000000000000000000000000011000000000000000000000000000000000
0000000000000000000000000000000000000000000001100000000000000000000000000000000
0000000000000000000000000000000001100000000011000000000000000000000000000000000
0000000000000000000000000000000000111111111110000000000000000000000000000000000
0000000000000000000000000000000000000000000000000000000000000000000000000000000
0000000000000000000000000000000000000111110000000000000000000000000000000000000
0000000000000000000000000000000000001100110000000000000000000000000000000000000
0000000000000000000000000000000000011000110000000000000000000000000000000000000
0000000000000000000000000000000001100000110000000000000000000000000000000000000
0000000000000000000000000000000011000000110000000000000000000000000000000000000
0000000000000000000000000000000011000000110000000000000000000000000000000000000
0000000000000000000000000000000011111111111110000000000000000000000000000000000
0000000000000000000000000000000000000000110000000000000000000000000000000000000
0000000000000000000000000000000000000000110000000000000000000000000000000000000
0000000000000000000000000000000000000000110000000000000000000000000000000000000
0000000000000000000000000000000000000011111100000000000000000000000000000000000
0000000000000000000000000000000000000000000000000000000000000000000000000000000
0000000000000000000000000000000001111111111111000000000000000000000000000000000
0000000000000000000000000000000001100000000000000000000000000000000000000000000
0000000000000000000000000000000001100000000000000000000000000000000000000000000
0000000000000000000000000000000001100000000000000000000000000000000000000000000
0000000000000000000000000000000001100000000000000000000000000000000000000000000
0000000000000000000000000000000001111111111000000000000000000000000000000000000
0000000000000000000000000000000000000000011110000000000000000000000000000000000
0000000000000000000000000000000000000000000011000000000000000000000000000000000
0000000000000000000000000000000000000000000001100000000000000000000000000000000
0000000000000000000000000000000001100000000011000000000000000000000000000000000
0000000000000000000000000000000000111111111110000000000000000000000000000000000
0000000000000000000000000000000000000000000000000000000000000000000000000000000